3333333333333333333
3211111113111111123
3133133313133313313
3133133313133313313
3111111111111111113
3133131333331313313
3111131113111311113
3133133313133313313
3133131113111313313
3211111311131111123
3333333333333333333
