33333333333333333333
31111111111111111113
31331313313313133313
31331313313313133313
31331311111113133313
31331333313333133313
31331111111111133313
31331333313333133313
31331333313333133313
31331333313333133313
31111111111111111113
33333333333333333333
